################################################################################################################################
#                                                                                                                             4#
#                                                                                                                             4#
#                                                                                                                             4#
#                                                                                                                             4#
#                                                                                                                             4#
#                                                                                                                             4#
#                                                                                                                             4#
#                                                                                                                             4#
#                                                                                                                             4#
#                                                                                                                             4#
################################################################################################################################
#                                                                                                                             4#
#                                                                                                                             4#
#                                                                                                                             4#
#                                                                                                                             4#
#                                                                                                                             4#
#                                                                                                                             4#
#                                                                                                                             4#
################################################################################################################################
#                                                                                                                            44#
#                                                                                                                            44#
#                                                                                                                            44#
#                                                                                                                            44#
#                                                                                                                            44#
#                                                                                                                            44#
#                                                                                                                            44#
#                                                                                                                            44#
#                                                                                                                            44#
#                                                                                                                            44#
#                                                                                                                            44#
#                                                                                                                            44#
#                                                                                                                            44#
#                                                                                                                            44#
#                                                                                                                            44#
#                                                                                                                            44#
#                                                                                                                            44#
#                                                                                                                            44#
#                                                                                                                            44#
#                                                                                                                            44#
#                                                                                                                            44#
#                                                                                                                            44#
#                                                                                                                            44#
#                                                                                                                            44#
#                                                                                                                            44#
#                                                                                                                            44#
#                                                                                                                            44#
#                                                                                                                            44#
#                                                                                                                            44#
#                                                                                                                            44#
#                                                                                                                            44#
#                                                                                                                            44#
#                                                                                                                            44#
#                                                                                                                            44#
#                                                                                                                            44#
#                                                                                                                            44#
#                                                                                                                            44#
#                                                                                                                            44#
#                                                                                                                            44#
#                                                                                                                            44#
#                                                                                                                            44#
#                                                                                                                            44#
#                                                                                                                            44#
#                                                                                                                            44#
#                                                                                                                            44#
#                                                                                                                            44#
#                                                                                                                            44#
#                                                                                                                            44#
#                                                                                                                            44#
#                                                                                                                            44#
#                                                                                                                            44#
#                                                                                                                            44#
#                                                                                                                            44#
#                                                                                                                            44#
#                                                                                                                            44#
#                                                                                                                            44#
#                                                                                                                            44#
#                                                                                                                            44#
#                                                                                                                            44#
#                                                                                                                            44#
#                                                                                                                            44#
#                                                                                                                            44#
#                                                                                                                            44#
#                                                                                                                            44#
#                                                                                                                            44#
#                                                                                                                            44#
#                                                                                                                            44#
#                                                                                                                            44#
#                                                                                                                            44#
#                                                                                                                            44#
#                                                                                                                            44#
#                                                                                                                            44#
#                                                                                                                            44#
#                                                                                                                            44#
#                                                                                                                            44#
#                                                                                                                            44#
#                                                                                                                            44#
################################################################################################################################
#                                                                                                                             4#
#                                                                                                                             4#
#                                                                                                                             4#
#                                                                                                                             4#
#                                                                                                                             4#
#                                                                                                                             4#
#                                                                                                                             4#
#                                                                                                                             4#
#                                                                                                                             4#
#                                                                                                                             4#
#                                                                                                                             4#
#                                                                                                                             4#
#                                                                                                                             4#
#                                                                                                                             4#
#                                                                                                                             4#
#                                                                                                                             4#
#                                                                                                                             4#
#                                                                                                                             4#
#                                                                                                                             4#
#                                                                                                                             4#
#                                                                                                                             4#
#                                                                                                                             4#
#                                                                                                                             4#
#                                                                                                                             4#
#                                                                                                                             4#
#                                                                                                                             4#
#                                                                                                                             4#
#                                                                                                                             4#
#                                                                                                                             4#
################################################################################################################################
